############  ############
#    #     #  #     #    #
#    #     #  #     #    #
#    #     #  #     #    #
##########################
#    #  #        #  #    #
#    #  #        #  #    #
######  ####  ####  ######
     #     #  #     #
     #     #  #     #
     #  ##########  #
     #  #        #  #
     #  #        #  #
#########        #########
     #  #        #  #
     #  #        #  #
     #  ##########  #
     #  #        #  #
     #  #        #  #
############  ############
#    #     #  #     #    #
#    #     #  #     #    #
###  ################  ###
  #  #  #        #  #  #
  #  #  #        #  #  #
######  ####  ####  ######
#          #  #          #
#          #  #          #
##########################